TILEMAP
32 22 							-- Size of tile map in tiles
20 20 					-- o 20 32 o 16 32			-- Tile size & block size
images/labuena.png			-- Tilesheet
12 5					-- Number of tiles in tilesheet
98					--Baldosas
4					--Numero de Enemigos p-portal m-skeleton n-archer o-vampire q-key r-gem s-stopwatch t-time u-main
CCJJJJJJJJJJJJJJJJJJJJJJJJJJJJCC
CC                            CC
CC                            CC
CC                            CC
CC     o                      CC
CCUUUUUUUU            UUUUUUUUCC
CC                            CC
CC                    m       CC
CC      UUUUUUaaaaUUUUUU      CC
CC            CCCC            CC
CC            CCCC            CC
CC      UUUUUUCCCCUUUUUU      CC
CC                            CC
CC      m                     CC
CC      UUUUUUUUUUUUUUUU      CC
CC                            CC
CC                    m       CC
CC      UUUUUUaaaaUUUUUU      CC
CC            CCCC            CC
CC            CCCC        p   CC
CCccccccccccccCCCCccccccccggccCC
CCCCCCCCCCCCCCCCCCCCCCCCCCCCCCCC